백엔드
  폴더구성 : 라우터 / 모델 / 컨트롤러 / 서비스 / 미들웨어 / 유틸 / config / index.js
  라우터 : 라우팅 처리
  모델 : 데이터베이스 스키마 정의
  컨트롤러 : 라우터에서 받은 요청을 처리
  서비스 : 컨트롤러에서 비즈니스 로직 처리
  미들웨어 : 요청과 응답 사이의 작업 처리
  유틸 : 공통 함수
  config : 환경 변수 설정

프론트엔드
  폴더구성 : 폴더 / 페이지 구성 트리구조로 설계
  컴포넌트 설계 : 화면정의서를 보면서 작성
    무슨 컴포넌트들을 만들지 정의
    만드는 방법을 정의 : 어떤 UI 라이브러리, 어떤 폴더 구성(아토믹디자인 어떻게 정의할까?), 어떤 방법론(모듈 or BEM)을 쓸까 등을 결정
  라이브러리 선정 :
    yarn, npm 중 뭘 쓸지 결정 : 필수사항, package.json 내부 설정
    Prettier, ESLint 설정 : 필수사항, npm run format:fix 등 스크립트 설정
    타입스크립트 설정 : 선택사항(tsconfig 또는 jsconfig.json 중 무엇을 쓸지), 그 안에서 BaseURL 등 설정
    테스트 설정 : 선택사항, npm run test 등 jest 코드 설정
    스토리북 설정 : 선택사항, npm run storybook 등 스토리북 설정
    라우터 설정 : 선택사항, react-router-dom 설치 및 설정
    상태관리 설정 : 선택사항, redux, recoil, mobx 등 설치 및 설정
    UI 라이브러리 설정 : 선택사항, material-ui, antd, bootstrap 등 설치 및 설정
    폴더 구성 : 선택사항, 아토믹 디자인, 컴포넌트별 폴더 구성 등
    모듈 or BEM 설정 : 필수사항, 모듈 or BEM 설정
    커스텀 CSS용 UI 라이브러리 설정 : 선택사항, CSS/SASS/SCSS 중 어느것을 쓸지 설정
    컴포넌트 작성 : 필수사항, 디폴트 컴포넌트 일부 작성

협업
  깃 설정 :
    브랜치 정책 설정 : 필수사항, 브랜치 정책 설정
    커밋 메시지 정책 설정 : 필수사항, 커밋 메시지 정책 설정
    이슈 정책 설정 : 필수사항, 이슈 정책 설정
    PR 정책 설정 : 필수사항, PR 정책 설정
    머지 정책 설정 : 필수사항, 머지 정책 설정
    릴리즈 정책 설정 : 필수사항, 릴리즈 정책 설정
  백로그 설정 : 
    매일, 매주 개발자들에게 주어질 태스크들을 쪼개고 개발할 순서(기한)와 우선도를 매겨서 할당되도록 설계
    태스크 관리 툴 선정 : 필수사항
    태스크 관리 툴을 깃허브와 연계 : 선택사항
    스크럼 설정 : 
      데일리스크럼, 업무분장회의, KPT, 스프린트리뷰... 중 어떤 회의들을 할지, 언제 할지 설정
      스프린트 주기 설정
  절차서 작성 :
    개발자들이 개발을 진행할 때 필요한 절차서를 작성
