[IT 전문 용어]

1. 설계 용어
  Microservice : 많은 서버를 대동하여 많은 유저들에게 서비스를 제공
  DDD : 도메인 주도 설계
  CDD : 컴포넌트 주도 개발
  TDD : 테스트 주도 개발
  CI : 지속적인 통합
  CD : 지속적인 배포
  DevOps : 개발과 운영의 합성어
  Agile : 애자일
  Scrum : 스크럼
  Kanban : 칸반
  Lean : 리안
  Pair Programming : 페어 프로그래밍
  Mob Programming : 모브 프로그래밍
  Refactoring : 리팩토링
  Code Review : 코드 리뷰
  Code Smell : 코드 스멜
  Clean Code : 클린 코드
  Clean Architecture : 클린 아키텍처
  SOLID : 객체 지향 프로그래밍의 다섯 가지 설계 원칙
  DRY : Don't Repeat Yourself
  KISS : Keep It Simple, Stupid
  YAGNI : You Aren't Gonna Need It
  OOP : 객체 지향 프로그래밍

2. 개발 용어
  API : Application Programming Interface
  REST : Representational State Transfer
  JSON : JavaScript Object Notation
  XML : Extensible Markup Language
  YAML : YAML Ain't Markup Language
  JWT : JSON Web Token
  OAuth : Open Authorization
  SSO : Single Sign On
  SAML : Security Assertion Markup Language
  CORS : Cross Origin Resource Sharing
  SPA : Single Page Application
  SSR : Server Side Rendering
  CSR : Client Side Rendering
  MPA : Multi Page Application
  MVC : Model View Controller
  MVVM : Model View ViewModel
  MVP : Model View Presenter
  MVP : Minimal Viable Product
  MSA : Micro Service Architecture
  SOA : Service Oriented Architecture
  BFF : Backend For Frontend
  CORS : Cross-Origin Resource Sharing
